NO ../textures/north.xpm
SO ../textures/south.xpm
WE ../textures/west.xpm
EA ../textures/east.xpm

F 220,100,0
C 225,30,0

111111
100001
101001
1000E1
111111
