NO ./textures/north.xpm
SO ./textures/south.xpm
WE ./textures/west.xpm
EA ./textures/east.xpm

F 220,100,0
C 225,30,0

11111111111111111111111111111111111111111111111111
10000000000000000000000000000000000000000000000001
10111111111111111111111111111111111111111111111101
10100000000000000000000000000000000000000000000101
10101000000000000000000000000000000000000000010101
10101010000000000000000000000000000000000000010101
10101010100000000000000000000000000000000010010101
11111111111D111111111111D1111111111111111111111111
10101010101N00000000000000000000000000000010010101
10101010100000000000000000000000000000000010010101
10101010000000000000000000000000000000000000010101
10101000000000000000000000000000000000000000010101
10101111111111111111111111111111111111111111110101
10100000000000000000000000000000000000000000000101
10000000000000000000000000000000000000000000000001
11111111111111111111111111111111111111111111111111
