NO ./textures/north.xpm
SO ./textures/south.xpm
WE ./textures/west.xpm
EA ./textures/east.xpm
B ./textures/box.xpm

F 220,100,0
C 225,30,0

11111111111111111111111111111111111111111111111111
10000000000000000000000000000000000000000000000001
10111111111111111111111111111111111111111111111101
101000000000000000000000000B00000000000000000B0101
10101000000000000000000000000000000000000000010101
10101010000000000000000000000000000000000000010101
1010101010000000B000000000000000000000000010010101
11111111111D111111111111D1111111111111111111111111
10101010101N00000000000000000000000000000010010101
10101010D000000000B00000D0000000000000000010010101
10101010000000000000000000000000000000000000010101
101010000000000B0000000000000000000000000000010101
101011111111111111111111D1111111111111111111110101
10100000000000000000B00000000000000000000000000101
1000000000000000000B000000000000000000000000000001
11111111111111111111111111111111111111111111111111
