no ./textures/north.xpm
so ./textures/south.xpm
we ./textures/west.xpm
ea ./textures/east.xpm

f 220,100,0
c 225,30,0

111111
100001
1000N1
111111
