NO ./textures/north.xpm
SO ./textures/south.xpm
WE ./textures/west.xpm
EA ./textures/east.xpm

F 001,002,003
C 000,255,000

111111
100001
1000N1
111111
