NO texture/north.xpm
SO texture/south.xpm
WE texture/west.xpm
EA texture/east.xpm

F 220,100,0
C 225,30,0

111111
100001
101001
1000N1
111111
